




  
  @@         @@@@  @@@@@@ @@@@@@ @@@@@ @@@@@@ @@@@@@
 @@         @@  @@ @@     @@     @@      @@   @@    
@@  @@@@@@  @@@@@@ @@@@@@ @@@@@@ @@@@@   @@   @@@@@@
 @@         @@  @@     @@     @@ @@      @@       @@
  @@        @@  @@ @@@@@@ @@@@@@ @@@@@   @@   @@@@@@