
  @@
 @@
@@  @@@@@@
 @@
  @@
        @@@@@@   @@@@@@   @@@@@  @@      @@@@@@@
       @@       @@    @@ @@   @@ @@      @@     
       @@   @@@ @@    @@ @@@@@@@ @@      @@@@@@@
       @@    @@ @@    @@ @@   @@ @@           @@
        @@@@@@   @@@@@@  @@   @@ @@@@@@@ @@@@@@@