     @@
   @@  @@
 @@      @@
     @@
     @@
     @@
     
  @@@@  @@@@      @@ @@@@  @@@ @@@@@@ @@ @@   @@ @@@@
 @@  @@ @@ @@     @@ @@   @@     @@   @@ @@   @@ @@  
 @@  @@ @@@@      @@ @@@@ @@     @@   @@ @@   @@ @@@@
 @@  @@ @@ @@ @@  @@ @@   @@     @@   @@  @@ @@  @@  
  @@@@  @@@@   @@@@  @@@@  @@@   @@   @@   @@@   @@@@